11 16
00 00 00 00 00 00 00 00 00 00 00 00 00 48 00 00
00 00 00 00 00 00 00 00 00 00 00 00 00 02 00 00
00 00 00 00 00 00 00 00 00 00 00 00 00 02 00 00
00 00 00 00 00 00 00 00 00 00 00 00 00 02 00 00
00 00 00 00 00 00 00 00 00 00 00 00 00 02 00 00
00 00 00 00 00 00 00 00 00 32 01 01 01 31 00 00
00 00 00 00 00 00 00 00 00 02 00 00 00 00 00 00
00 00 00 00 00 00 00 00 00 02 00 00 00 00 00 00
00 00 00 00 00 00 00 00 00 33 01 01 01 01 01 47
00 00 00 00 00 00 00 00 00 00 00 00 00 00 00 00
00 00 00 00 00 00 00 00 00 00 00 00 00 00 00 00


