11 16
00 00 00 00 00 00 00 00 00 00 00 00 00 00 00 00
00 00 00 00 00 00 00 00 00 00 00 00 00 00 00 00
00 00 00 00 00 00 00 00 00 00 00 00 00 00 00 00
00 00 00 00 32 07 01 01 07 01 01 07 34 00 00 00
00 00 00 00 02 02 00 00 02 00 00 02 02 00 00 00
00 00 00 00 02 02 00 00 02 00 00 02 02 00 00 00
00 00 00 00 33 05 01 01 07 01 01 05 31 00 00 00
00 00 00 00 00 02 00 00 00 00 00 02 00 00 00 00
00 00 00 00 00 02 00 00 00 00 00 02 00 00 00 00
00 00 00 00 00 82 00 00 00 00 00 80 00 00 00 00
00 00 00 00 00 00 00 00 00 00 00 00 00 00 00 00


