11 16
00 00 00 00 00 00 00 02 00 00 00 00 00 00 00 00
00 00 00 00 00 00 00 02 00 00 00 00 00 00 00 00
00 00 00 00 54 01 01 07 00 00 00 00 00 00 00 00
00 00 01 01 54 01 01 05 34 00 00 00 00 00 00 00
00 00 00 01 00 01 01 02 02 00 00 00 00 00 00 00
00 00 32 01 34 00 00 02 02 00 00 00 00 00 00 00
00 00 02 00 02 01 01 02 02 00 00 00 00 00 00 00
47 01 31 00 02 00 00 02 02 00 00 00 00 00 00 00
00 00 00 00 02 00 00 02 02 00 00 00 00 00 00 00
00 00 00 00 33 01 01 07 31 00 00 00 00 00 00 00
00 00 00 00 00 00 00 00 00 00 00 00 00 00 00 00






